{
    "test": {
        "tiletbl": {
            ".": "air",
            "#": "wall"
        },
        "tiles": [
            "#######..#######",
            "................",
            "................",
            "#..##......##..#",
            "#..##......##..#",
            "#..............#",
            "................",
            "................",
            "................",
            "................",
            "#..............#",
            "#..##......##..#",
            "#..##......##..#",
            "................",
            "................",
            "#######..#######"
        ]
    }
}